0 0 0 0 0 0 0 0 0 0 0 0 0 0 0 0 0 0 0 0 0 0 0 0 0 0 0 0 0 0 0 0 0 0 0 0 0 0 0 0
7 7 7 7 7 7 1 1 1 1 1 1 1 1 1 1 1 1 1 1 1 1 1 1 1 1 1 1 1 1 1 1 1 1 1 1 1 1 1 1
7 7 7 7 7 1 1 1 1 1 1 1 1 1 1 1 1 1 1 1 1 1 1 1 1 1 1 1 1 1 1 1 1 1 1 1 1 1 1 1
7 7 7 7 7 1 1 1 1 1 1 1 1 0 0 0 0 0 0 0 0 0 0 0 0 0 0 0 0 0 0 0 0 0 0 0 0 0 0 0
0 0 0 0 0 0 0 0 0 0 1 1 7 2 2 2 2 2 2 2 2 2 2 2 2 2 2 2 2 2 2 2 2 2 2 2 2 2 2 2
0 0 0 0 0 0 0 0 0 0 1 1 7 2 2 2 2 2 2 2 2 2 2 2 2 2 2 2 2 2 2 2 2 2 2 2 2 2 2 2
0 0 0 7 7 7 7 7 7 7 1 1 7 2 2 4 0 0 6 4 4 6 0 4 2 2 2 7 7 7 7 7 7 7 7 7 7 7 7 7
0 0 0 7 7 7 7 7 7 7 1 1 7 2 2 20 0 0 0 0 4 0 0 0 20 2 2 7 7 7 7 7 7 7 7 7 7 7 7 7
0 0 0 0 0 0 0 0 0 0 0 1 1 7 2 2 0 0 0 35 0 0 0 0 0 2 2 7 1 7 7 7 20 4 4 4 20 7 7 7
0 0 0 0 0 0 0 0 0 0 0 0 1 1 7 2 2 4 0 35 0 0 0 0 0 4 2 2 7 1 7 7 7 0 0 4 0 0 0 7
7 7 7 7 7 7 7 0 0 0 0 0 0 1 1 7 2 2 0 35 0 0 0 0 0 0 2 2 7 1 7 7 0 0 0 0 0 4 0 7
7 7 7 7 7 7 7 0 0 0 0 0 0 1 1 7 2 2 2 1 1 1 2 2 2 2 2 7 1 7 7 0 0 0 0 6 4 6 0 7
0 0 0 0 0 0 0 0 0 0 0 0 0 0 1 1 1 1 1 1 1 1 1 1 1 1 1 1 7 7 0 0 0 0 4 0 6 0 4 7
0 0 0 0 0 0 0 0 0 0 0 0 0 0 0 0 0 0 0 0 0 0 0 0 0 0 0 0 0 0 0 0 0 0 4 0 0 0 4 7
7 7 7 7 7 7 7 7 7 0 0 0 0 0 0 0 0 0 0 0 0 0 0 0 0 0 0 0 0 0 0 0 0 0 0 6 6 6 0 7
7 7 7 7 7 7 7 7 7 0 0 0 0 0 0 3 3 3 3 3 3 0 0 0 0 0 0 0 0 0 0 0 3 3 3 3 7 7 7 7
3 3 3 3 3 3 3 0 0 0 0 0 0 0 3 3 3 0 0 0 0 0 0 0 0 0 0 0 0 0 3 3 0 0 0 0 3 3 7 7
3 3 4 4 6 0 0 0 0 0 0 0 0 3 3 3 0 0 0 0 0 0 0 0 0 0 0 0 0 3 3 0 0 0 0 0 0 3 3 7
3 3 4 4 6 0 0 0 0 0 0 0 3 3 3 0 0 0 0 0 0 3 3 3 3 0 0 0 0 0 0 0 0 0 0 0 0 0 3 3
3 3 3 3 3 3 3 3 3 3 3 3 3 3 3 3 3 3 3 3 3 3 3 3 3 3 3 3 3 3 3 3 3 3 3 3 3 3 3 3