2 2 2 2 2 2 2 2 2 2 2 2 2 2 2 2 2 2 2 2 2 2 2 2 2 2 2 2 2 2 2 2 2 2 2 2 2 2 2 2
1 2 2 2 2 2 2 2 2 2 2 2 2 2 2 2 2 2 2 2 2 2 2 2 2 2 2 2 2 2 2 2 2 2 2 1 1 1 1 1
3 1 2 2 2 2 2 2 2 2 2 2 2 2 2 2 2 2 2 2 2 2 2 2 2 2 2 2 1 1 1 1 1 1 1 1 1 1 1 1
3 3 1 1 1 1 2 2 2 2 2 2 2 2 2 1 1 1 1 1 1 1 1 1 1 1 1 1 1 1 1 1 1 1 1 1 1 1 1 7
3 3 3 1 1 1 1 1 1 2 2 2 1 1 1 1 1 1 1 1 1 1 1 1 1 1 1 1 1 1 1 1 1 1 1 7 7 7 7 7
3 3 3 3 0 0 0 0 0 1 1 1 0 20 1 1 1 1 1 1 1 1 1 1 1 1 1 1 1 7 7 7 7 7 7 7 7 7 7 7
3 3 3 3 3 0 0 0 0 0 0 0 0 0 0 1 1 7 1 1 1 1 1 1 1 6 1 7 7 7 7 7 7 7 7 7 7 7 7 7
3 3 0 3 3 3 0 0 0 0 0 0 0 20 7 7 7 7 7 1 1 1 1 1 1 1 1 1 7 7 7 7 7 7 7 7 7 7 7 7
3 0 0 3 3 3 0 0 0 0 0 0 0 7 7 7 7 7 7 7 1 1 6 1 1 6 1 1 1 7 7 7 7 7 7 7 7 7 7 7
3 0 0 0 3 3 3 0 0 0 0 0 0 0 0 0 7 7 7 7 7 1 1 1 6 1 1 1 1 7 7 7 7 7 7 7 7 7 7 7
3 3 0 0 0 3 3 0 0 0 0 0 7 0 0 0 7 0 7 7 7 7 7 1 1 1 1 1 7 7 7 7 7 7 7 7 7 7 7 7
3 3 0 0 20 3 0 0 0 0 0 0 7 7 7 7 7 0 0 7 7 7 7 7 1 6 1 7 7 7 7 7 7 7 7 7 7 7 7 7
3 3 0 0 0 0 0 0 0 0 0 0 20 0 7 7 0 0 7 7 7 7 7 7 7 7 7 7 7 7 7 7 7 7 7 7 7 7 7 7
3 0 0 0 0 0 0 3 3 20 0 0 0 0 0 7 0 7 7 7 7 7 7 7 7 7 7 7 7 7 7 7 7 7 7 7 7 7 7 7
3 0 0 0 0 20 3 3 3 7 7 0 0 7 0 7 0 0 0 0 7 7 7 7 7 7 7 0 0 0 0 0 0 0 0 0 0 7 7 7
3 0 0 0 0 0 3 3 3 0 7 7 7 0 0 0 7 7 0 0 0 0 0 0 0 0 0 0 0 0 0 0 0 0 4 20 4 0 7 7
3 0 0 0 0 0 3 3 3 0 0 7 0 0 0 0 0 0 0 0 0 0 0 0 0 0 0 0 0 0 0 0 0 0 0 4 0 4 20 7
3 0 0 0 0 3 3 3 3 3 0 7 7 0 0 0 0 0 0 0 0 0 0 0 7 7 7 0 0 0 0 0 0 4 0 4 4 4 0 7
3 3 0 0 3 3 3 3 3 3 0 0 0 0 0 7 7 7 0 0 0 0 7 7 7 7 7 7 7 7 0 0 0 0 20 0 20 4 7 7
3 3 3 3 3 3 3 3 3 3 3 7 7 7 7 7 7 7 7 7 7 7 7 7 7 7 7 7 7 7 7 7 7 7 7 7 7 7 7 7
