7 7 7 7 7 7 7 7 7 7 7 7 7 7 7 7 7 7 7 7 7 7 7 7 7 7 7 7 7 7 7 7 7 7 7 7 7 7 7 7
7 7 7 7 7 20 0 4 6 4 0 20 7 7 7 7 7 7 7 7 7 7 7 7 7 7 7 7 7 7 7 7 7 7 7 7 7 7 7 7
7 7 7 7 7 0 0 4 0 0 0 0 0 7 7 7 7 7 7 7 7 7 7 7 7 7 7 0 0 0 0 0 0 0 0 0 0 0 0 0 0
7 7 7 7 7 0 0 0 0 0 0 0 0 0 0 0 0 0 0 0 20 0 0 0 0 0 0 0 0 0 0 0 0 0 0 0 0 0 0 0
7 7 7 7 7 7 7 7 7 7 7 7 7 7 7 7 0 0 0 0 0 0 0 0 0 0 0 0 0 0 0 0 0 0 0 0 0 0 0 0
7 7 20 0 0 0 0 0 0 0 0 0 0 0 20 0 0 0 0 20 0 3 3 0 0 3 3 3 3 3 3 3 3 3 3 3 3 3 3 3
7 7 0 0 0 0 0 0 0 0 0 0 0 0 0 7 0 7 0 0 0 0 3 0 0 0 0 3 3 3 3 3 3 3 3 3 3 3 3 3
7 7 0 0 0 0 0 7 7 7 7 0 0 0 0 7 7 7 0 0 0 0 3 0 0 0 0 0 3 3 3 3 3 3 3 3 3 20 3 3
7 7 7 0 0 0 0 7 4 4 4 0 0 0 0 7 7 0 0 0 0 0 3 3 3 3 3 3 3 0 0 3 3 3 0 0 4 4 3 3
7 7 7 0 0 0 0 7 6 4 6 0 0 0 0 7 0 0 0 0 0 0 0 0 0 0 0 0 0 0 0 0 0 0 0 0 4 3 3 3
7 7 7 0 0 0 0 7 7 7 7 7 7 7 7 7 20 0 0 0 0 0 0 0 0 0 0 0 0 0 0 0 0 0 0 0 6 3 3 3
7 7 7 0 0 0 0 0 0 0 0 0 0 0 0 0 0 0 0 0 0 0 0 0 0 0 3 3 3 3 0 0 0 0 0 0 4 6 3 3
7 7 0 0 0 0 0 0 0 0 0 0 0 0 0 0 0 0 0 0 0 0 0 0 20 3 3 3 3 3 3 3 3 0 0 0 4 20 3 3
7 7 0 0 4 4 0 0 0 7 7 7 1 1 1 0 0 0 0 0 0 1 1 1 3 3 3 3 3 3 3 3 3 3 3 3 3 3 3 3
7 7 20 6 4 4 20 7 7 7 7 7 1 1 1 1 1 1 1 1 1 1 1 1 1 1 1 1 20 3 3 3 3 3 3 3 3 3 3
7 7 7 7 7 7 7 7 7 7 7 7 7 7 7 7 7 1 1 1 1 1 1 1 1 1 1 1 1 3 3 3 3 3 3 3 3 3 3 3
2 2 2 2 2 2 2 2 2 2 2 2 2 1 1 20 1 1 1 1 1 1 1 1 1 20 1 1 2 2 2 2 2 2 2 2 2 2 2 2
2 2 2 2 2 2 2 2 2 2 2 2 2 2 2 2 2 2 2 2 2 2 2 2 2 2 2 2 2 2 2 2 2 2 2 2 2 2 2 2
2 2 2 2 2 2 2 2 2 2 2 2 2 2 2 2 2 2 2 2 2 2 2 2 2 2 2 2 2 2 2 2 2 2 2 2 2 2 2 2
2 2 2 2 2 2 2 2 2 2 2 2 2 2 2 2 2 2 2 2 2 2 2 2 2 2 2 2 2 2 2 2 2 2 2 2 2 2 2 2